W W W W W W G W
W G G G G G G G
W G W W G W W G
W G B B G W W G
W G G G G G G G
W G W W G W W W
W G W W G W W W
W G G G G G G G
W G W W G W W W
W G W W G W W W
W G G G G G G G
W G W W G W B B