W G W W G W W W
W G G G G W W W
W G W W G G G G
W G W W W W G W
W G G G G G G G
W W W W W G W W
W G G G W G G G
W B B G W W G W
W B B G W W G W
W G G G G G G G
W G G G G G G G
W W W G B B G W