W W W W W W W W
G G W G G G W G
B G G G W G G G
G G W G G G W G
B G G G W G G G
G G W G G G W G
W W W W W W W G
G G G G G G G G
W G G G W G G W
G G W G G G B W
W G G G W G G W
W W W W W B G W