W W W W W W W W
G G G W G G G B
G B G G G W G G
G G G W G G G W
G W G G G W G G
G G G W G G G W
G W W W W W W W
G G G G G G G G
W G W W G W W G
W G W W G W W G
W G G G G G G G
W G B B G B B G