G W G W G W G W
G G G G G G G G
G W G B G B G B
G G G G G G G G
G B G B G W G W
W W G G W W W W
G W G W W G G G
G W G G W W G W
G W W W W G G G
G G G G W W G W
G G G G W W W W
G W W G W G G G