G W W G W G G G
G G G G W G G W
W W W G W G G W
G G G G G G G G
G W B G B W G W
G W W G W W G B
G G G G G G G G
W W W W W W G B
G G G G G G G B
W G W W W G G G
G G G G G G G G
W W W W W W W W