W W W W W W W W
W W W G W W B W
G G G G G G B W
B W W G W G G W
G G G G W G G W
W B W G G G G W
W W W G B G G W
G G G G W G G W
G W W G G G G W
G W W G W G G W
G G G G W G G W
G W W G G G G W