G G W G G G G W
W G G G W G G W
W G G G W G G W
G G W G G G G W
W B W G G G G W
B B W G B G B W
G G W G W W W W
W G G G G B B W
B G G G G G W W
G G W G W G G W
G G W G W G G W
W W W W W W W W