W W W G G W W W
W G G G G G G W
W G G G G G G W
W G G G G G G W
W G G G G G G W
W G G T T G G W
W G G T T G G W
W G G G G G G W
W G G G G G G W
W G G G G G G W
W G G G G G G W
W W W G G W W W
