W W W W W G G W
W G G G G G G W
W G G G G G G W
W G G G W G G W
W G G G W G G W
W W G W W G G W
W G G G W G G G
W G G G G G G G
W G G G G G G W
W B G G W G G W
W W B G W G G W
W W W W W W W W
