W W W W W W W W
W W W G G G G G
W W G G G G G G
W G G G G G G G
G G G G G G G G
G G G G G G G G
W G G G G G G G
W G G G G G G G
W G G G G G G G
W G G G G G G G
W B G G G B W W
W W W G G W W W