W W W G G W W W
W G G G G W B W
W G G G G W G W
W G G G G G G W
W G G G G G G W
G G G G G G G G
G G G G G G G G
W G G G G G G W
W W G G G G G W
W W W G G G G W
W W W B G G G W
W W W W W G G W