B G G G G G G G
W G G W W G G W
B G W W W G W W
W G G W W G G W
B G G G G G G G
W G G B B G G B
B G G G G G G G
W G G W W G G W
B G W W W G W W
W G G W W G G W
B G G G G G G G
W G G G G G G G