B G G G G G G G
W G B W W B W W
B G W G G W G G
W G W G G G G G
B G W G G W G G
W G B G G B W W
B G G G G W G G
W G G G G W G G
B G B G G G G G
W G W G G W G G
B G B W W B W W
W G G G G G G G