B W B W B W B W
G G G G G G G G
W G G G G G G G
W G B W W W W B
W G W G G G G W
G G G G G G G W
B G G G G G G W
G G W G G G G W
W G B W W W W W
W G W G G G G W
W G G G G G G W
G G W G G G G W