G G W G G G G W
W G B W W W W B
W G G G G G G G
W G G G G G G G
G G B W W W W B
B G W G G G G W
G G W G G G G W
W G G G G G G W
W G G G G G G W
W G W G G G G W
G G B W W W W B
G G G G G G G G