G G G G G G G G
W W W B G B W W
G G G W G G G G
G G G G G G G G
G G G W G W G G
W W W B G B W W
G G G W G W G G
G G G W G W G G
G G G W G W G G
G G G W G W G G
W W W B G B W W
G G G G G G G G