B W B W B W B W
G G G G G G G G
G G G G G G G G
W W W G W W B G
W G G G G G W G
W G G G G G W G
W G G G G G B G
W G G G G G W G
W W B B W W W G
W G G G G G W G
W G G G G G B G
W G G G G G W G