W G G G G G W G
W W W G W W B G
G G G G G G G G
G G G G G G G G
W W B W W W B G
W G G G G G W G
W G G G G G W G
W G G G G G W G
W G G G G G W G
W G G G G G W G
B W W G G W B G
G G G G G G G G