G G G G G G G G
W W G W B G G W
G G G G W G W W
G G G G W G G W
G G G G W G G G
B W W W B G G B
G G G G G G G G
G G G G G G G W
W B W W W G W W
G G G G G G G W
G G G G G G G G
W B W B W B W B