G G G G G G G W
W G G W W G B B
W G W W W G G W
W G G W W G B B
G G G G G G G W
B G G B B G B B
G G G G G G G W
W G G W W G B B
W G W W W G G W
W G G W W G B B
G G G G G G G W
G G G G G G G B