W W W W W W W W
W G G G G G G G
W G G W G G G G
W G W W G G W B
W G W G G W W B
W G W G B G G G
W G G W G G G G
W G G W W G G G
W G G G G W G G
W G G G G G W G
W G G G G G W G
W B G G G G G W