W G W G W W W G
W G W G G G W G
W G W B G G G G
W G W G B G G G
W W G G G G G B
W W G G G G B G
W W G G G G G G
W W G G G G G G
W W G G G G G B
W W G G G G G G
W W G G G G G B
W W G G G G B G