W W W W W W W W
G G G G G G G G
G W W G G G G G
B G G W G G G G
B G G W W G G G
G B G G W W G G
G B G G G W G W
G B G G G G W W
G B G G G G G G
G B G G W W G G
G G B G G W W W
W G G G W G G G