G W G W G W B B
G G G G W G G G
G G G G G W G G
G G G G G G G G
B G W W G G G W
G W G G W G G G
G W W G G G G B
G G B W G G G B
B G G G W G G G
G G G G G W G G
B G G G G W W W
G W W G W G G G