W W W W W W W W
G G G G G G G G
G G G G G G G G
G G G G G G G G
G G G W W W G G
G G G G G G W G
W G W G G G B W
W W W G G B G G
G G W G G G G B
G G W W B G G G
W G G W W G G G
G G G G W G W W