B G G G G G G G
G B G G W W W W
G W W W W G G G
G W G G G G G W
W G G G G G W G
G G G G G G G G
B G G G G G G G
B G G B G G G G
G G B B G G G G
G G G B G G G G
W G G G G G W W
G G G G G G G G