W W G G W W W W
G G G G G G G W
G G G G G G G W
G G G B G G G W
G G B B G W G W
B G B B G W G W
G G G B G W G W
G G G G G W G W
G G G G G W G W
W G G G G W G W
G W W G G W G W
G B G W G W G W