G B G W G W G W
W W G G G W G W
G G W G G W G W
W W G G G W G W
G G G G G W G W
G G G G G W G W
G G G B G W G W
G G B B G W G W
G G G B G W G W
G G G G G G W W
W W G G G G G W
G G W G W G G W